العشيراء	NOTFOUND
العشب	عُشْب,عَشِب
العشاءين	NOTFOUND
العسيرة	عَسِير
العسيراء	NOTFOUND
العسير	عَسِير
العسيب	عَسِيب
العزب	عَزَب,عِزْبَة,أَعْزَب
العزالي	NOTFOUND
العري	عُرْوَة,عُرْي
العرك	عَرْك
العرفي	عُرْفِيّ
العرعري	NOTFOUND
العرصة	عَرْصَة
العربة	عَرَبَة
العراقي	عِراقِيّ
العراجين	عُرْجُون
العذرات	NOTFOUND
العذاري	عَذْراء
العدول	عُدُول
العدوان	عُدْوان,عَدُوّ
العجيفي	NOTFOUND
العجيج	عَجِيج
العجوز	عَجُوز
العجلة	عَجَلَة
العتبة	عَتَبَة
العتاب	عِتاب
العتائر	NOTFOUND
العبيد	عُبَيْد,عَبْد
العبلات	NOTFOUND
العبقري	عَبْقَرِيّ
العبشمية	NOTFOUND
العبراني	عِبْرانِيّ
العبرات	عَبْرَة
العباداني	NOTFOUND
العباءة	عَبايَة
العامريين	NOTFOUND
العادة	عادَة
العائن	NOTFOUND
الظنون	ظَنُون,ظُنُون
الظماء	ظَماء
الظما	NOTFOUND
الظلمات	ظُلْمَة
الظلماء	ظَلْماء
الظلف	ظِلْف
الظفري	NOTFOUND
الظريب	NOTFOUND
الظرار	NOTFOUND
الظان	NOTFOUND
الظ	لَظِي-َ
الطيبين	طَيِّب
الطوال	طَوِيل
الطهراني	طَهْرانِيّ
الطنبذي	NOTFOUND
الطنافس	طُنْفُسَة
الطلوع	طُلُوع
الطلحات	NOTFOUND
الطل	طَلّ
الطفاوة	طَفاوَة,طُفاوَة
الطرفاء	طَرْفاء
الطرسوسي	NOTFOUND
الطرائفي	NOTFOUND
الطحين	طَحِين
الطبيب	طَبِيب
الطبل	طَبْل
الطبقة	طَبَقَة
الطارق	طارِق
الطاحي	NOTFOUND
الطابع	طابِع
الضوء	ضَوْء
الضماد	ضِماد
الضغابيس	NOTFOUND
الضعيفين	ضَعِيف
الضعيفة	ضَعِيف
الضعف	ضُعْف,ضِعْف
الضرورة	ضَرُورَة
الضربتين	ضَرْبَة
الضراب	NOTFOUND
الضحية	ضَحِيَّة
الصوبج	NOTFOUND
الصنم	صَنَم
الصنع	صَنْع,صُنْع
الصنابح	NOTFOUND
الصكاك	صَكّ
الصقرين	صَقْر
الصقته	أَلْصَق
الصفير	صَفِير
الصفقة	صَفْقَة
الصفراوات	NOTFOUND
الصفراء	أَصْفَر
الصفان	صَفّ
الصفاق	صِفاق
الصفات	صِفَة
الصريمية	NOTFOUND
الصرد	صَرْد
الصرة	صُرَّة
الصراخ	صَرّاخ,صُراخ
الصدور	صَدْر,صُدُور
الصخور	صَخْر
الصحاح	صِحاح,صَحِيح
الصبيحي	NOTFOUND
الصبغ	صِبْغ
الصبة	NOTFOUND
الصباغون	صَبّاغ
الصباة	NOTFOUND
الصانع	صانِع
الصافات	NOTFOUND
الصاعين	صاع
الصاعان	صاع
الصابرون	صابِر
الصائد	NOTFOUND
الشيص	NOTFOUND
الشيزي	NOTFOUND
الشيرازي	شِيرازِيّ
الشيخان	شَيْخ
الشيبة	شِيبَة,شَيْبَة
الشوط	شَوْط
الشهيدة	شَهِيد
الشهران	شَهْر
الشهادات	شَهادَة
الشنائي	NOTFOUND
الشموس	شَمُوس,شَمْس
الشمش	NOTFOUND
الشماتة	شَماتَة
الشلاء	أَشَلّ
الشكاة	شَكاة
الشقر	أَشْقَر,شَقَر
الشفيع	شَفِيع
الشفتين	شِفْت,شَفَة
الشفار	شَفْرَة
الشعوب	شَعْب
الشعف	NOTFOUND
الشعبين	شَعْب
الشعاف	شَعْفَة
الشريكين	شَرِيك
الشروي	شَرْوَى
الشرقية	شَرْقِيّ
الشرقاء	NOTFOUND
الشرف	شَرَف
الشرعبي	NOTFOUND
الشرح	شَرْح
الشراج	NOTFOUND
الشديدة	شَدِيد
الشدة	شِدَّة
الشدائد	شَدائِد
الشحم	شَحِم,شَحْم
الشجرتان	شَجَرَة,شَجِر
الشجاع	شُجاع
الشبور	شَبُّور
الشبت	شِبِتّ
الشاهدان	شاهِد
الشاميين	شامِيّ
الشامات	شامَة
الشاحب	شاحِب
الشاتان	شاة
الشات	NOTFOUND
الشؤمي	أَشْأَم
السيوب	NOTFOUND
السيلحاني	NOTFOUND
السياقة	سِياقَة
السياري	NOTFOUND
السياحة	سَيّاح,سِياحَة
السوس	سُوس
السورتان	سُورَة
السود	أَسْوَد
السواقي	ساقِيَة
السواحل	ساحِل
السهمية	NOTFOUND
السهلة	سَهْل
السهر	سَهَر,سُهَر
السهام	سَهْم
السنوت	NOTFOUND
السندره	NOTFOUND
السنتكم	لِسان
السمير	سَمِير
السمود	سُمُود
السمك	سُمْك,سَمَك
السمراء	أَسْمَر
السمانة	سَمانَة
السماطين	NOTFOUND
السماسم	NOTFOUND
السماءين	NOTFOUND
السليك	NOTFOUND
السليطي	سُلَيْطِيّ
السليحي	NOTFOUND
السلمات	NOTFOUND
السلعي	سِلَعِيّ
السلامفي	NOTFOUND
السلاطين	سُلْطان
السل	سَلّ,سِلّ
السكركة	NOTFOUND
السك	لاس,سَكّ,أَلَّس,أَسَكّ,وَلَس-ِ
السقر	سَقَر
السفق	NOTFOUND
السعداء	سَعِيد
السطيحتين	سَطِيح
السطر	سَطْر
السريانية	سُرْيانِيّ
السرماري	NOTFOUND
السرر	سُرَّة
السرحي	NOTFOUND
السرحات	NOTFOUND
السربة	سُرْبَة
السراري	سُرِّيَّة
السرادق	سُرادِق
السراء	سَرّاء
السدة	سُدَّة,سَدَّة
السد	سَدّ,سُدّ
السخي	سَخِيّ
السخلة	سَخْلَة
السخاب	NOTFOUND
السحمي	NOTFOUND
السحت	سُحْت
السجع	سَجْع
الستور	سِتْر
السبقة	سُبْقَة,سَبْقَة
السبط	سِبْط,سَبِط
السبخة	سَبِخ,سَبَخَة
السبتان	سَبَت
السبايا	سَبِيّ
السباي	NOTFOUND
السبال	سَبَلَة
السباحتين	سَبّاح
السبائي	NOTFOUND
السامعين	سامِع
السامع	سامِع
السالمي	سالِمِيّ
السالفة	سالِف
السالحيني	NOTFOUND
السالحاني	NOTFOUND
السافلين	سافِل
الساعدين	ساعِد
الساعدية	NOTFOUND
الساجد	ساجِد
الساج	ساج
السابغ	سابِغ
السابح	سابِح
السائلون	سائِل
السائبة	سائِب
الس	لاس,أَلَّس,وَلَس-ِ
الزوائد	NOTFOUND
الزهريون	NOTFOUND
الزهريلا	NOTFOUND
الزهريعن	NOTFOUND
الزهراوين	NOTFOUND
الزهد	زُهْد
الزنية	NOTFOUND
الزنج	زَنْج
الزنبيل	زَنْبِيل
الزمي	أَلْزَم
الزمهن	أَلْزَم,لَزِم-َ
الزمهم	أَلْزَم,لَزِم-َ
الزمنا	أَلْزَم,لَزِم-َ
الزمزمة	زَمْزَمَة
الزمر	زَمْر,زُمْرَة
الزمته	أَلْزَم
الزقته	أَلْزَق
الزقاق	زَقّ,زُقاق
الزق	لَزِق-َ,زَقّ,لَزَّق,أَلْزَق
الزفير	زَفِير
الزعيم	زَعِيم
الزر	زِرّ
الزخرف	زُخْرُف
الزجر	زَجْر
الزبيل	NOTFOUND
الزبيد	زُبَيْد
الزبن	زَبُون
الزانيان	زانِي
الزان	زان
الزائر	زائِر
الزائد	زائِد
الريش	رِيش
الريحان	رَيْحان,رَيِّح
الرويحة	NOTFOUND
الرويجل	NOTFOUND
الروحة	رَوْحَة
الرهيط	NOTFOUND
الرهبة	رَهْبَة
الرمليين	رَمْلِيّ
الرمض	رَمَض
الرمد	رَمَد,رَمِد
الرمان	رُمّان
الرمادي	رَمادِيّ
الركية	NOTFOUND
الركي	NOTFOUND
الركوب	رَكُوب,رُكُوب
الركنان	رُكْن
الركع	راكِع
الركس	NOTFOUND
الركابين	رِكاب,رَكّاب
الركائب	رَكُوب,رِكاب
الرقيين	NOTFOUND
الرقيع	رَقِيع
الرقيان	NOTFOUND
الرقوب	رُقُوب
الرقعة	رُقْعَة
الرقبة	رَقَبَة,رِقْبَة
الرقاق	رُقاق,رَقِيق,رِقاق
الرقاد	رُقاد
الرق	رَقّ,رِقّ
الرفقاء	رَفِيق
الرغيف	رَغِيف
الرغوة	رَغْوَة
الرغبة	رَغْبَة
الرغاء	رَغّاء
الرعاف	رُعاف
الرطبة	رَطْب,رُطَب
الرطاب	رَطِيب
الرصغ	NOTFOUND
الرصاص	رَصاص
الرشوة	رَشْوَة
الرشدة	رَشْدَة
الرسالة	رِسالَة
الرزاقاخبرنا	NOTFOUND
الرز	رُزّ
الرذالة	رَذالَة
الردم	رَدْم
الردئ	NOTFOUND
الرد	رَدّ
الرخامي	رُخامِيّ
الرحمنبن	NOTFOUND
الرحا	NOTFOUND
الرجلة	NOTFOUND
الرجحان	رُجْحان
الرجاء	رَجاء
الرتع	NOTFOUND
الربعة	رَبْعَة
الربذي	NOTFOUND
الربح	رِبْح
الربالي	NOTFOUND
الرباعية	رُباعِيّ
الربابة	رَبابَة
الربائث	NOTFOUND
الرام	رام
الراكع	راكِع
الراكبين	راكِب
الرافلة	NOTFOUND
الرافقي	NOTFOUND
الرافعي	NOTFOUND
الراضيات	راضِي
الراشد	راشِد
الراسبية	NOTFOUND
الرادفة	NOTFOUND
الراجفة	NOTFOUND
الراجع	راجِع
الرائي	رائِي
الرائحة	رائِحَة,رائِح
الراء	راء
الذيب	ذِيب
الذمار	ذِمار
الذليل	ذَلِيل
الذكري	ذِكْرَى,ذَكَرِيّ
الذر	ذَرّ
الذبيحة	ذَبِيح,ذَبِيحَة
الذئاب	ذِئْب
الدويري	NOTFOUND
الدونقي	NOTFOUND
الدون	دُونَ,دُون
الدود	دُود
الدواة	دَواة
الدهيماء	NOTFOUND
الدهناء	دَهْناء
الدهقان	دِهْقان
الدهان	دِهان,دُهْن,دَهّان
الدنان	دِنان
الدمامة	دَمامَة
الدليل	دَلِيل
الدلدل	دُلْدُل
الدقيقي	دَقِيقِيّ
الدفن	دَفْن
الدفق	دَفْق
الدفر	دَفَر,دَفِر
الدعداع	NOTFOUND
الدروع	دِرْع
الدرنة	دَرَنَة
الدرفس	NOTFOUND
الدرة	دِرَّة,دُرّ
الدرابجردي	NOTFOUND
الدخيل	دَخِيل
الدخن	دُخْن,دَخَن
الدخشم	NOTFOUND
الدبري	دَبَرِيّ
الدبرة	دَبْرَة
الداعيان	داعِي
الدابر	دابِر
الدائن	دائِن
الدئلي	NOTFOUND
الخيواني	NOTFOUND
الخيلان	خَيْل,خال
الخيطين	NOTFOUND
الخيطان	خَيْط
الخوان	خَوّان,خائِن,خُوان
الخواضون	NOTFOUND
الخواص	خاصَّة
الخوارزمي	NOTFOUND
الخنازير	خِنْزِير
الخمص	NOTFOUND
الخمسمائة	خَمْسمائَة
الخليطين	خَلِيط
الخلوة	خَلْوَة
الخلقان	خَلَق,خُلْقان
الخلد	خَلَد,خُلْد
الخلاف	خِلاف
الخلاخيل	خَلْخال
الخلابة	خَلّاب,خِلابَة
الخطي	خَطِّيّ,خَطْوَة
الخطوة	خَطْوَة
الخطفة	خَطْفَة
الخطط	خُطَّة
الخطباء	خَطِيب
الخطب	خُطْبَة
الخطام	خِطام
الخطاء	خَطَأ
الخضرة	خُضْرَة
الخصي	خَصِيّ,خُصْيَة
الخصمين	خَصْم
الخصمان	خَصِيم,خَصْم
الخصر	خَصْر
الخصاصة	خَصاصَة,خَصاص
الخص	لَخَّص,خَصّ,خُصّ
الخشخاش	خَشْخاش
الخزف	خَزَف
الخزرجي	خَزْرَجِيّ
الخزاعية	NOTFOUND
الخريطة	خَرِيطَة
الخريبي	NOTFOUND
الخرقة	خُرْقَة,خِرْقَة
الخرقاء	أَخْرَق
الخربة	خَرِب,خُرْبَة
الخرب	خَرِب
الخراصون	خَرّاص
الخراب	خَراب
الخراء	خَراء
الخدمة	خِدْمَة
الخداع	خِداع,خَدّاع
الخبخبة	NOTFOUND
الخبائري	NOTFOUND
الخامشة	NOTFOUND
الخالدات	خالِد
الخالتين	خالَة
الخاص	خاصّ
الخاشع	خاشِع
الخارص	NOTFOUND
الخائفين	خائِف
الحيين	حَيّ,أَلْحَى
الحيلة	حِيلَة
الحيسة	NOTFOUND
الحيتان	حُوت,حَيّ,حَيَّة
الحياض	حِياض,حَوْض
الحواشي	حاشِيَة
الحوائج	حاجَة
الحواء	حَوّاء
الحنوط	NOTFOUND
الحنظل	حَنْظَل
الحنة	لَحَّن,أَلْحَن,أَلاح,لَحَن-َ,حَنَّة
الحنبل	حَنْبَل
الحناجر	حَنْجَر
الحميل	حَمِيل
الحموقة	NOTFOUND
الحمق	حُمْق,أَحْمَق
الحمصيان	حِمْصِيّ
الحمصة	NOTFOUND
الحمساء	أَحْمَس
الحلس	حِلْس
الحلاف	NOTFOUND
الحكمي	حُكْمِيّ
الحقيبة	حَقِيبَة
الحقني	أَلْحَق,لَحِق-َ
الحقك	أَلْحَق,لَحِق-َ
الحقت	أَلْحَق
الحقائب	حَقِيبَة
الحقاء	حَقْو
الحفيظ	حَفِيظ
الحفيرة	حَفِير,حَفِيرَة
الحطمة	حِطْمَة
الحصيرة	حَصِير
الحصيب	NOTFOUND
الحصون	حِصْن
الحصر	حُصْر,حَصْر
الحصان	حِصان
الحسيس	حَسِيس
الحسيب	حَسِيب
الحسوة	حَسْوَة
الحسنفي	NOTFOUND
الحسر	حَسَر,حَسِر
الحساء	حَساء
الحزورة	حَزُّورَة
الحريق	حَرِيق
الحريش	NOTFOUND
الحريسة	NOTFOUND
الحريث	NOTFOUND
الحرمين	حَرَم
الحرمي	حَرَمِيّ
الحرق	حَرْق
الحرتين	حُرّ,حَرَّة
الحرانيان	NOTFOUND
الحدين	NOTFOUND
الحديثولم	NOTFOUND
الحديثوبعضهم	NOTFOUND
الحدياة	NOTFOUND
الحدور	حَدُور
الحدثي	NOTFOUND
الحدثاني	NOTFOUND
الحجون	NOTFOUND
الحجوري	NOTFOUND
الحجل	حَجْل
الحجج	حُجَّة
الحبيق	NOTFOUND
الحبير	NOTFOUND
الحبيبة	حُبَيْبَة,حَبِيب
الحامي	حامِيّ,حامِي
الحاكة	حائِك
الحافر	حافِر
الحادي	حادِي,إِلْحادِيّ,إِلْحاد,لَحْد
الحاد	إِلْحاد,حادّ,لَحْد
الحاجات	حاجَة
الحائل	حائِل
الجيزي	NOTFOUND
الجيران	جار
الجيب	جَيْب,جِيْب
الجياد	جَيِّد
الجوف	جَوْف,أَجْوَف
الجوشن	NOTFOUND
الجودي	NOTFOUND
الجود	NOTFOUND
الجوخان	NOTFOUND
الجوبري	NOTFOUND
الجوباري	NOTFOUND
الجوامع	جامِع
الجواظ	NOTFOUND
الجهلاء	جاهِل
الجهجاه	NOTFOUND
الجهال	جاهِل
الجهادين	NOTFOUND
الجنيون	NOTFOUND
الجنيد	NOTFOUND
الجنوب	جَنُوب
الجنه	جِنَّة,جَنَّة,لَجِن-َ,جُنَّة
الجندي	جُنْدِيّ
الجندعيين	NOTFOUND
الجند	جُنْد
الجناية	جِنايَة
الجنادب	جُنْدُب
الجناح	جُناح,جَناح
الجميل	جَمِيل
الجمه	لِجام,لَجَّم,جَمّ,لَجَم,أَلْجَم
الجمحية	NOTFOUND
الجمجمة	جُمْجُمَة,جَمْجَمَة
الجماجم	جُمْجُمَة
الجم	لَجَّم,جَمّ,لَجَم,أَلْجَم
الجلودي	NOTFOUND
الجلساء	جَلِيس
الجلاس	جُلّاس
الجعودة	NOTFOUND
الجعلان	جُعْل
الجعل	جُعْل,جَعْل
الجعظري	NOTFOUND
الجريدة	جَرِيدَة
الجريد	جَرِيد
الجرف	جُرْف,جَرْف
الجران	NOTFOUND
الجرادتان	جَراد
الجرادة	جَراد
الجذوة	جَذْوَة
الجذمي	أَجْذَم
الجذعتين	NOTFOUND
الجذر	جِذْر
الجدول	جَدْوَل
الجدود	جَدّ,جُدُود
الجدل	جَدَل
الجدعاني	NOTFOUND
الجدب	جَدْب
الجبت	NOTFOUND
الجبان	جُبّ,جَبان,جَبّان
الجبارين	جَبّار
الجبائر	جَبِيرَة
الجانبين	جانِب
الجالب	جالِب
الجاعرتين	NOTFOUND
الجاريتين	جارِي,جارِيَة
الجاحدين	جاحِد
الجاتهم	NOTFOUND
الجابية	جابِي,جابِيَة
الجائر	جائِر
الج	وَلَج-ِ,لَجّ-َِ
الثيبات	ثَيِّب
الثنيتين	ثَنِيَّة,ثَنْيَة
الثندوة	ثُنْدُوَة
الثلثان	ثُلْث
الثلاثمائة	ثَلاثمائَة
الثقيلة	ثَقِيل
الثقب	ثُقْب,ثَقْب,ثُقْبَة
الثغر	ثَغْر,ثُغْرَة
الثغامة	NOTFOUND
الثغام	ثَغام
الثغ	لَثِغ-َ,أَلْثَغ
الثعلبيين	ثَعْلَبِيّ
الثروة	ثَرْوَة
الثديين	ثَدْي
الثدية	NOTFOUND
الثبور	ثُبُور
الثاليل	NOTFOUND
الثار	NOTFOUND
الثاء	ثاء
التييسمونها	NOTFOUND
التيه	تِيه,آلَة
التيسير	تَيْسِير
التيجان	تاج
التياسر	NOTFOUND
التويتات	NOTFOUND
التوقيت	تَوْقِيت
التوسعة	تَوْسِعَة
التورع	NOTFOUND
التوبةانطلق	NOTFOUND
التواضع	تَواضُع
التوابين	تَوّاب
التهجد	NOTFOUND
التنفس	تَنَفُّس
التنازع	تَنازُع
التميميحدثنا	NOTFOUND
التمندل	NOTFOUND
التمسوه	ٱِلْتَمَس
التمسه	ٱِلْتَمَس
التمست	ٱِلْتَمَس
التلقين	تَلْقِين
التلف	تَلَف
التلدن	NOTFOUND
التل	تَلّ
التكلف	تَكَلُّف
التكفير	تَكْفِير
التقيا	ٱِلْتَقَى
التقوا	ٱِلْتَقَى
التقط	ٱِلْتَقَط
التقشف	تَقَشُّف
التقدمة	تَقْدِمَة
التقحل	NOTFOUND
التفع	ٱِلْتَفَع
التفحش	NOTFOUND
التفاحة	تُفّاح
التعفف	تَعَفُّف
التعزية	تَعْزِيَة
التعريف	تَعْرِيف
التعريس	تَعْرِيس
التطهر	NOTFOUND
التشكي	NOTFOUND
التشعب	تَشَعُّب
التشبه	تَشَبُّه
التسمية	تَسْمِيَة
التسرع	تَسَرُّع
التستر	تَسَتُّر
التسبيحات	تَسْبِيح
الترياق	تِرْياق
الترة	NOTFOUND
التذكرة	تَذْكِرَة,تَذْكَرَة
التخير	NOTFOUND
التخليل	NOTFOUND
التخلل	NOTFOUND
التحنث	NOTFOUND
التحريم	تَحْرِيم
التحريق	NOTFOUND
التحالق	NOTFOUND
التجسس	تَجَسُّس
التجبر	NOTFOUND
التجارات	NOTFOUND
التثبيت	تَثْبِيت
التثاوب	NOTFOUND
التبكير	NOTFOUND
التبرز	NOTFOUND
التبرر	NOTFOUND
التبر	تِبْر
التاويل	NOTFOUND
التامين	تامّ,تَأْمِين
التافه	تافِه
التاريخ	تارِيخ
التاديب	تَأْدِيب
التاخر	تَأَخُّر
التاج	تاج
التابوه	NOTFOUND
التابعة	تابِع
التائب	تائِب
التاء	تاء
التئمي	NOTFOUND
التئما	NOTFOUND
التؤدة	تُؤَدَة
الة	لَهِي-َ,أَلَّه,وَلِه-َِ,آل,لَها,أَلْهَى,وَلِي-ِ,إِلٰه,لَهَّى,آلَة
البيعين	NOTFOUND
البيضتين	بَيْض
البياع	بَيّاع
البياذقة	NOTFOUND
البوق	بُوق
البوري	بُورِي
البواقي	بَواقِي
البوار	بَوار
البواب	بَوّاب
البنين	بِنِين,بِن
البلوغ	بُلُوغ
البلقاء	أَبْلَق
البلعوم	بُلْعُوم
البلة	أَبْلَه,بَلَه,بِلَّة
البلاغ	بَلاغ
البكران	بَكْر
البقاع	بِقاع
البغيض	بَغِيض
البغلة	بَغْل
البغض	بُغْض
البعرة	NOTFOUND
البعر	بَعْر
البظور	بَظْر
البطون	بُطُون
البطئ	NOTFOUND
البضاعة	بِضاعَة
البصريين	بَصْرِيّ,بَصَرِيّ
البصريون	بَصْرِيّ,بَصَرِيّ
البصاق	بُصاق
البشع	بَشِع
البساتين	بُسْتان
البز	بُزّ,بَزّ
البرهان	بُرْهان
البرند	NOTFOUND
البركي	NOTFOUND
البرص	بُرْص,بَرَص
البرسام	بِرْسام
البردي	بَرَدَى,بَرْدِيّ
البرح	NOTFOUND
البربر	بَرْبَرِيّ
البديع	بَدِيع
البدريين	NOTFOUND
البختج	NOTFOUND
البحور	بَحْر
البتيراء	NOTFOUND
الباوردي	NOTFOUND
الباهلية	NOTFOUND
البانهم	أَلْبانِيّ,لَبَن
البالغين	بالِغ
الباكية	باكِي
الباكم	أَلَب,أَلَّب
الباقين	باقِي
الباقيتين	باقِي
الباقرة	NOTFOUND
البازر	NOTFOUND
الباز	باز
البارز	بارِز
البار	بارّ
البادئ	بادِئ
الايلاء	إِيلاء
الايفع	NOTFOUND
الايد	NOTFOUND
الايتام	يَتِيم
الاوداج	وَدَج
الانيار	نِير
الانفين	أَنْف,آنِف
الانفراد	ٱِنْفِراد
الانعمي	NOTFOUND
الانصاريون	أَنْصارِيّ
الانصاريقال	NOTFOUND
الانسي	أَنَسِيّ,إِنْسِيّ
الاندراوردي	NOTFOUND
الانجوج	NOTFOUND
الانتصار	ٱِنْتِصار
الانتباذ	NOTFOUND
الانباط	نَبَطِيّ
الانبات	NOTFOUND
الاناث	أُنْثَى
الاناة	أَناة,أَلان
الامية	أُمِّيّ,أُمِّيَّة
الاملح	أَمْلَح
الاملاجتان	NOTFOUND
الامرة	إِمْرَة,آمِر
الامثال	مِثْل,مَثَل
الامانات	أَمانَة
الالفاظ	لَفْظ
الالسنة	لِسان
الاكياس	كَيِّس,كِيس
الاكفاء	كَفْء
الاكرام	إِكْرام
الاكار	أَكّار
الاقناء	قُنْو
الاقفال	إِقْفال,قُفْل
الاقفاص	قَفَص
الاقرم	NOTFOUND
الاقراء	إِقْراء
الاقبر	NOTFOUND
الاقاليد	إِقْلِيد
الافلح	أَفْلَح
الافلت	NOTFOUND
الافراد	إِفْراد,فَرْد
الافتراش	NOTFOUND
الاغطش	NOTFOUND
الاغاليق	NOTFOUND
الاعيس	أَعْيَس
الاعنق	عَناق
الاعنز	عَنْز
الاعنة	لاعَن,عِنان
الاعمشعن	NOTFOUND
الاعليحدثنا	NOTFOUND
الاعطية	عَطاء
الاعضب	NOTFOUND
الاعضاء	عُضْو
الاعصار	إِعْصار,عَصْر
الاعسر	أَعْسَر
الاعتصام	ٱِعْتِصام
الاعتدال	ٱِعْتِدال
الاعبد	NOTFOUND
الاظلاف	ظِلْف
الاطول	أَطْوَل
الاطباق	طَبَق,إِطْباق
الاضياف	NOTFOUND
الاضبط	أَضْبَط
الاصلع	أَصْلَع
الاصلاح	إِصْلاح
الاصفاد	صَفَد,صِفاد,إِصْفاد
الاصحاب	صاحِب
الاصح	أَصَحّ
الاصباح	صُبْح
الاصابة	إِصابَة
الاشوع	NOTFOUND
الاشعر	أَشْعَر
الاشطاط	NOTFOUND
الاشر	أَشِر,أَشَر
الاشتمال	NOTFOUND
الاشتر	NOTFOUND
الاشبع	NOTFOUND
الاشام	NOTFOUND
الاشاءتين	NOTFOUND
الاسنة	سِنّ,آسِن
الاسنادمثله	NOTFOUND
الاسمين	ٱِسْم
الاسمان	ٱِسْم
الاسل	أَسَل
الاسقف	سَقْف,أُسْقُف
الاسفاطي	NOTFOUND
الاسري	أُسَرِيّ,أَسِير
الاستنان	NOTFOUND
الاستعجال	ٱِسْتِعْجال
الاستعاذة	NOTFOUND
الاستطالة	ٱِسْتِطالَة
الاستطابة	NOTFOUND
الاستحياء	ٱِسْتِحْياء
الاستحقاق	ٱِسْتِحْقاق
الاستجمار	NOTFOUND
الاستجابة	ٱِسْتِجابَة
الاستثناء	ٱِسْتِثْناء
الاستئناس	NOTFOUND
الاسبذيين	NOTFOUND
الاسبذي	NOTFOUND
الاسباطي	NOTFOUND
الاسباب	سَبَب
الاسارير	أَسارِير
الازرة	NOTFOUND
الازرار	زِرّ
الاروية	أُرْوِيَّة
الارنبين	أَرْنَب
الارق	آرِق,أَرِق,أَرَق,أَرَقّ
الارضة	أَرَضَة
الارضالتي	NOTFOUND
الارزي	NOTFOUND
الاردية	رِداء,أُرْدِيّ
الارجوحة	أَرْجُوحَة,أُرْجُوحَة
الارجاء	أَرْجاء,إِرْجاء
الارتداد	ٱِرْتِداد
الاذني	أُذُنِيّ
الاذفر	NOTFOUND
الاديان	دِين
الادواء	دَوَى,داء
الادب	أَدَب,آدِب,أَدْب
الاخنسيين	NOTFOUND
الاخفياء	NOTFOUND
الاختلاق	ٱِخْتِلاق
الاخت	أُخْت
الاحيان	حِين
الاحمسية	NOTFOUND
الاحمري	NOTFOUND
الاحلافي	NOTFOUND
الاحتكار	ٱِحْتِكار
الاحب	أَحَبّ
الاحابيش	NOTFOUND
الاجوفان	أَجْوَف
الاجهار	NOTFOUND
الاجلاب	NOTFOUND
الاجزاء	جُزْء
الاجتهاد	ٱِجْتِهاد
الاجتناب	ٱِجْتِناب
الاجتماع	ٱِجْتِماع
الاثمان	آثِم,ثُمْن,ثَمَن,إِثْم
الاثران	أَثَر,أَثِر
الاثخان	NOTFOUND
الاثبج	NOTFOUND
الاثبات	إِثْبات
الاثافي	أُثْفِيَّة
الاتقياء	تَقِيّ
الاترج	NOTFOUND
الابيرق	NOTFOUND
الابوال	بَوْل
الابناوي	NOTFOUND
الابلة	أَبْلَه,أُبُلَّة
الابطال	بَطَل,إِبْطال
الابريز	إِبْرِيز
الابراد	بُرْد
الابتلاء	ٱِبْتِلاء
الابتداء	ٱِبْتِداء
الاباعر	بَعِير
الاء	آلاء
اكيس	أَكِيس,كاس-ِ,أَكْيَس,كَيَّس
اكونن	NOTFOUND
اكولا	أَكُول
اكوعه	NOTFOUND
اكوعك	NOTFOUND
اكني	وَكَى-ِ,كَنَى-ِ,كَنَّى
اكننت	أَكَنّ
اكنف	كَنَف,أَكْنَف
اكنز	كَنَز-ِ
اكمامه	NOTFOUND
اكمئ	NOTFOUND
اكليهما	آكِل,أَكْل
اكلي	آكِل,أُكُل,أَكْل
اكلو	آكِل
اكلني	أَكَّل,آكَل,كال-ِ,أَكَلّ,أَكَل,وَكَل-ِ
اكلمها	كَلَّم
اكلفك	أَكْلَف,كَلَّف
اكلتموه	أَكَّل,آكَل,أَكَل
اكلب	كَلِب-َ,كَلَّب
اكلات	آكِل,أَكْلَة
اكفيكها	NOTFOUND
اكفيكماه	NOTFOUND
اكفها	وَكَف-ِ,كَفّ,كَفَى-ِ
اكفني	وَكَف-ِ,كَفَن-ِ,كَفّ,كَفَى-ِ,كَفَّن
اكفف	كَفَّف,كَفّ
اكفت	كَفَت-ِ,كَفَّت
اكفانه	كَفَن
اكفالها	NOTFOUND
اكفاء	كَفْء
اكسية	كِساء,أَكْسَى
اكسي	أَكْسَى,كَسا,كَسِي-َ
اكسوك	أَكْسَى,كَسا
اكسوتنيها	NOTFOUND
اكسها	وَكَس-ِ,أَكْسَى,كَسا,كَسِي-َ
اكسكم	وَكَس-ِ,أَكْسَى,كَسا,كَسِي-َ
اكسروها	NOTFOUND
اكسرا	NOTFOUND
اكروا	آكَر,أَكَر-ِ,أَكْرَى
اكرههم	كَرِه-َ,كَرَّه,أَكْرَه
اكرهك	كَرِه-َ,كَرَّه,أَكْرَه
اكرهت	أَكْرَه
اكرموا	أَكْرَم
اكرمكم	أَكْرَم,كَرَّم
اكرمته	أَكْرَم
اكرمتك	أَكْرَم
اكرة	آكَر,كَرِه-َ,كَرُه,كَرَّه,أَكَر-ِ,كَرّ,أَكْرَه,كَرا,كَرِي-َ,كَرَى-ِ,أَكْر,أُكْرَة,أَكْرَى
اكراهية	إِكْراهِيّ
اكراه	آكَر,إِكْراه,أَكَر-ِ,أَكْرَى
اكرام	إِكْرام
اكذبوا	أَكْذَب
اكثف	كَثَّف,أَكْثَف,كَثُف
اكثرن	أَكْثَر
اكثركن	أَكْثَر,كَثَّر
اكثاركم	إِكْثار
اكثار	إِكْثار
اكتويت	ٱِكْتَوَى
اكتموا	NOTFOUND
اكتفي	أَكْتَف,ٱِكْتَفَى
اكتسي	ٱِكْتَسَى
اكتراها	ٱِكْتَرَى
اكتحلوا	ٱِكْتَحَل
اكتحلتم	ٱِكْتَحَل
اكتحلت	ٱِكْتَحَل
اكتبي	NOTFOUND
اكتبوه	أَكْتَب
اكتباها	أَكْتَب
اكتافها	كَتِف,كِتْف
اكتافنا	كِتْف,كَتِف
اكبسه	كَبَّس,كَبَس-ِ
اكبت	أَكْبَى,أَكَبّ,كَبَت-ِ
اكبادها	كَبِد
اكباد	كَبِد
اكانوا	كان
اكانت	كان
اك	وَكَى-ِ
اقيلوا	أَقال
اقيضه	قاض-ِ,قَيَّض
اقيضك	قاض-ِ,قَيَّض
اقيدكها	NOTFOUND
اقيامه	NOTFOUND
اقودها	قاد,أَقْوَد
اقني	قَنَى-ِ,آق,قَنا,وَقَى-ِ,أَقْنَى
اقنت	قَنَت
اقناء	قُنْو
اقمر	أَقْمَر,قَمَر-ِ,قَمِر-َ,قَمَّر
اقمتها	أَقام
اقماتك	NOTFOUND
اقلها	قَلا,قال,أَقال,قَلِي-َ,أَقَلّ,قَلَى-ِ
اقلنسوة	NOTFOUND
اقلعت	أَقْلَع
اقلتك	أَقال,أَقَلّ
اقلبناه	NOTFOUND
اقفيتهما	قَفاً
اقفل	قَفَل,قَفَل-ِ,أَقْفَل,قَفَّل
اقفر	أَقْفَر,قَفَر
اقفالها	إِقْفال,قُفْل
اقعدوا	أَقْعَد
اقعدكما	قَعَد,أَقْعَد,قَعَّد
