اقعاء	NOTFOUND
اقطعوا	أَقْطَع
اقطعتها	أَقْطَع
اقضيكها	NOTFOUND
اقضيا	NOTFOUND
اقضني	قَضّ,قاض-ِ,قَضَّى,قَضَى-ِ,قاض
اقصار	NOTFOUND
اقشعررت	ٱِقْشَعَرّ
اقرها	وَقَر-ِ,أَقَرّ,قَرَى-ِ,قَرا,قَرّ-َِ
اقرنا	وَقَر-ِ,أَقَرّ,أَقْرَن,قَرَى-ِ,قَرَن-ِ,قَرا,قَرّ-َِ
اقرعت	NOTFOUND
اقرضني	قَرَّض,قَرَض-ِ,أَقْرَض
اقرض	قَرَّض,قَرَض-ِ,أَقْرَض
اقرصة	قَرَص,قَرَّص
اقربيك	أَقْرَب
اقربه	قَرَّب,قِراب,أَقْرَب,قَرِب-َ,قَرُب
اقربكم	قَرَّب,أَقْرَب,قَرِب-َ,قَرُب
اقراهم	أَقَرّ
اقرانها	قِرْن
اقرانكم	قِرْن
اقراكم	أَقَرّ
اقراره	إِقْرار
اقراتكه	NOTFOUND
اقراء	إِقْراء
اقرئها	أَقْرَأ
اقرئت	NOTFOUND
اقرؤكم	NOTFOUND
اقرءوها	NOTFOUND
اقرءوه	NOTFOUND
اقدمه	أَقْدَم,قَدَّم,قَدِم-َ
اقتلوهم	NOTFOUND
اقتلني	قَتَل,قَتَّل
اقتطاع	ٱِقْتِطاع
اقتصوا	ٱِقْتَصّ
اقتصرتها	NOTFOUND
اقتسموها	ٱِقْتَسَم
اقتسمناه	ٱِقْتَسَم
اقترف	ٱِقْتَرَف
اقتراها	ٱِقْتَرَى,أَقْتَر
اقتراب	ٱِقْتِراب
اقتدي	ٱِقْتَدَى
اقتتل	ٱِقْتَتَل
اقتبسوه	ٱِقْتَبَس
اقتاديه	NOTFOUND
اقتابه	قَتَب
اقبور	NOTFOUND
اقبلوها	أَقْبَل
اقبله	قَبَّل,أَقْبَل,قَبِل-َ
اقبضوا	NOTFOUND
اقبضني	قَبَّض,قَبَض-ِ
اقبض	قَبَّض,قَبَض-ِ
اقبر	قَبَر,أَقْبَر
اقبالي	إِقْبال
اقامهن	أَقام
اقامها	أَقام
اقاما	أَقام
اقالها	أَقال
اقالنا	أَقال
اقالتا	إِقالَة,أَقال
اقاضيك	قاضَى
اقارب	قارَب,أَقْرَب
اقاد	أَقاد
اقاتله	قاتَل
افيه	وَفَى-ِ
افيما	NOTFOUND
افيلتزمه	NOTFOUND
افيكسر	NOTFOUND
افيك	وَفَى-ِ
افيق	أَفاق
افياخذ	NOTFOUND
افواههما	فُوه
افواهنا	فُوه
افواهكم	فُوه
افواها	فُوه
افواجا	فَوْج
افواج	فَوْج
افهقناه	NOTFOUND
افنيتهم	فِناء,أَفْنَى
افنلت	NOTFOUND
افنكتها	NOTFOUND
افنكتم	NOTFOUND
افنعرف	NOTFOUND
افنضرب	NOTFOUND
افنسعدهن	NOTFOUND
افندخلها	NOTFOUND
افند	فَنَّد,أَفْنَد
افنادا	NOTFOUND
افناء	إِفْناء
افمن	NOTFOUND
افلك	آفِل,فَلّ,فَلَى-ِ,أَفَل,فَلَّى
افلحنا	فَلَح-َ,أَفْلَح
افلحن	أَفْلَح
افلائها	فِلْو,فَلاً
افكنت	NOTFOUND
افكنا	فَكّ,إِفْك,أَفْك,أَفَك-ِ
افكل	NOTFOUND
افك	فَكّ,إِفْك,وَفَى-ِ,أَفْك,أَفَك-ِ
افقرني	أَفْقَر
افقرناك	أَفْقَر
افقد	فَقَد-ِ,أَفْقَد
افقت	أَفاق
اففت	NOTFOUND
افغلب	NOTFOUND
افعجبتم	NOTFOUND
افطنت	NOTFOUND
افطرتا	أَفْطَر
افطرا	أَفْطَر
افضها	أَفاض,فَضَّى,فاض-ِ,وَفَض-ِ,فَضّ,أَفْضَى,فَضا
افضلهما	فَضَّل,أَفْضَل
افضلنا	فَضَّل,أَفْضَل
افصح	فَصُح,أَفْصَح
افشي	أَفْشَى
افسدوه	أَفْسَد
افسدوا	أَفْسَد
افسدهم	فَسَّد,فَسَد,أَفْسَد
افسدتهم	أَفْسَد
افسخ	فَسِخ-َ,فَسَخ-َ
افسحوا	أَفْسَح
افساده	إِفْساد
افزعك	فَزَّع,أَفْزَع
افزع	فَزِع-َ,فَزَّع,أَفْزَع
افريضة	NOTFOUND
افري	أَفْرَى,فَرَّى,فَرَى-ِ
افرض	فَرَض-ِ
افرش	فَرَش,فَرَّش,فَرَش-ِ
افردوا	أَفْرَد
افردت	أَفْرَد
افرج	فَرَّج,أَفْرَج
افرايتك	NOTFOUND
افراغ	إِفْراغ
افراطكم	إِفْراط
افراسنا	فَرَس
افراس	فَرَس
افديه	فَدَى-ِ
افحمتها	أَفْحَم
افحسبت	NOTFOUND
افتلومني	NOTFOUND
افتكحلها	NOTFOUND
افتقسمون	NOTFOUND
افتقرت	ٱِفْتَقَر
افتقدناه	ٱِفْتَقَد
افتقدنا	ٱِفْتَقَد
افتغتسل	NOTFOUND
افتعلوا	ٱِفْتَعَل
افتضها	ٱِفْتَضّ
افتستحقون	NOTFOUND
افترقوا	ٱِفْتَرَق
افترقتا	ٱِفْتَرَق
افتراه	ٱِفْتَرّ,أَفْتَر,ٱِفْتَرَى
افتذهبون	NOTFOUND
افتدي	ٱِفْتَدَى
افتدري	NOTFOUND
افتحوا	فَتَح-َ
افتحلف	NOTFOUND
افتحرمه	NOTFOUND
افتجعلونه	NOTFOUND
افتجزي	NOTFOUND
افتجد	NOTFOUND
افتتها	فَتّ,فَتَّت,أَفْتَى,ٱِفْتات
افتتحوا	ٱِفْتَتَح
افتاه	أَفْتَى,آفَة
افتانا	أَفْتَى,آفَة
افتامنين	NOTFOUND
افتاكم	أَفْتَى,آفَة
افتاك	أَفْتَى,آفَة
افتاركهم	NOTFOUND
افت	فَتّ,أَفْتَى,فَتِي-َ,فات
افانقضها	NOTFOUND
افانزلت	NOTFOUND
افانزل	NOTFOUND
افانتقل	NOTFOUND
افانا	أَفِين
افامرهن	NOTFOUND
افاكتحل	NOTFOUND
افاقرا	NOTFOUND
افاقته	أَفّاق,أَفاق,إِفاقَة
افاقة	أَفّاق,أَفاق,إِفاقَة,أُفُق
افاعشرهم	NOTFOUND
افاعتق	NOTFOUND
افاضل	فاضِل,فاضَل
افاضتهم	إِفاضَة,أَفاض
افاصله	فاصَل
افاشترط	NOTFOUND
افاسترقي	NOTFOUND
افارقه	فارَق,أَفْرِيقِيّ
افارقكم	فارَق
افاخرجته	NOTFOUND
افاخذ	NOTFOUND
افاختصي	NOTFOUND
افاخبرك	NOTFOUND
افاحيص	أُفْحُوص
افاحله	NOTFOUND
افاحدث	NOTFOUND
افاجزيه	NOTFOUND
افابيعها	NOTFOUND
افابيعه	NOTFOUND
افابتاعه	NOTFOUND
افا	NOTFOUND
افئدتهم	فُؤاد
اغيظك	أَغاظ,غَيَّظ,غاظ-ِ
اغيظ	أَغاظ,غَيَّظ,غاظ-ِ
اغيره	غَيَّر,أَغار
اغيرنا	غَيَّر,أَغار
اغيثه	أَغاث,غاث-ِ
اغنياءهم	غَنِيّ
اغنها	أَغْنَى,غَنِي-َ,غَنَّى,غَنّ-َ,أَغَنّ
اغناني	أَغْنَى,أَغَنّ
اغمر	غَمَر,غَمُر
اغماض	NOTFOUND
اغمارا	غَمْر
اغلقه	غَلَق-ِ,أَغْلَق
اغلقته	أَغْلَق
اغلاها	أَغَلّ,أَغْلَى
اغلال	غُلّ
اغلاق	غَلَق,إِغْلاق
اغفيت	أَغْفَى
اغفاله	غُفْل,إِغْفال
اغضبتكم	أَغْضَب
اغضبت	أَغْضَب
اغصب	غَصَب-ِ
اغصان	غُصْن
اغشاه	غَشِي-َ,أَغْشَى
اغسليه	NOTFOUND
اغسلهما	غَسَّل,غَسَل-ِ
اغسلها	غَسَّل,غَسَل-ِ
اغزوك	غَزا
اغز	غَزا,أَغَزّ
اغرورقت	ٱِغْرَوْرَق
اغرنا	غَرَّى,غَرا,أَغَرّ,غَرّ,غار,أَغْرَى,أَغار
اغرت	أَغار,أَغْرَى
اغربه	أَغْرَب,غَرَب,غُراب,غَرَّب
اغذ	غَذا,غَذّ-ِ,غَذَّى,أَغَذّ
اغث	أَغاث,غَثّ-ِ,غَثَى-ِ,أَغْثَى,غاث-ِ
اغتلمت	ٱِغْتَلَم
اغتلم	ٱِغْتَلَم
اغتسلوا	ٱِغْتَسَل
اعيي	عَيِي-َ,أَعْيَى
اعيه	عَيِي-َ,أَعْيَى,وَعَى-ِ
اعينه	أَعان,عَيْن,عَيَّن
اعيننا	أَعان,عَيْن
اعينكم	أَعان,عَيْن,عَيَّن
اعيروها	NOTFOUND
اعيذك	أَعاذ
اعيدوها	NOTFOUND
اعيدوه	NOTFOUND
اعياكم	أَعْيَى
اعيادهم	عِيد
اعياد	عِيد
اعوله	عال,عَوَّل,أَعْوَل
اعول	عال,عَوَّل,أَعْوَل
اعوضكم	عَوَّض,عاض
اعوذه	عَوَّذ,عاذ
اعودك	عاد,عَوَّد
اعوججنا	ٱِعْوَجّ
اعوججت	ٱِعْوَجّ
اعواني	عَوْن
اعواده	عُود
اعندهم	NOTFOUND
اعناقها	عُنْق
اعناقكما	عُنْق
اعميان	أَعْمَى
اعمرو	NOTFOUND
اعمرته	أَعْمَر
اعمرت	أَعْمَر
اعمامه	NOTFOUND
اعماله	عَمَل
اعم	أَعْمَى,عَمِي-َ,عَمّ,عام,عَمَّى
اعليها	أَعْلَى,عَلَّى
اعلو	عَلا
اعلنه	أَعال,أَعْلَن
اعلناه	أَعال,أَعْلَن
اعلن	أَعال,أَعْلَن
اعلموه	أَعْلَم,عَلِم-َ
اعلمها	أَعْلَم,عَلِم-َ,عَلَّم
اعلمناك	أَعْلَم
اعلقوا	NOTFOUND
اعلاقنا	NOTFOUND
اعقصته	NOTFOUND
اعقدن	NOTFOUND
اعقاب	عُقْب
اعق	عاق,أَعَقّ,أَعاق,عَقّ
اعفه	عَفِيف,عَفّ-ِ,أَعَفّ,عاف,عَفَّى,عاف-ِ,عَفا,أَعْفَى
اعفة	عَفِيف,أَعَفّ,عَفّ-ِ,عاف,عَفَّى,عاف-ِ,عَفا,أَعْفَى
اعفاه	أَعَفّ,أَعْفَى
اعظمهن	أَعْظَم,عَظَّم
اعظمهما	أَعْظَم,عَظَّم
اعظمه	أَعْظَم,عَظَّم
اعظاما	NOTFOUND
اعطيهما	أَعْطَى
اعطيناهم	أَعْطَى
اعطيناها	أَعْطَى
اعطيناه	أَعْطَى
اعطيناكها	NOTFOUND
اعطيكه	NOTFOUND
اعطيتيها	NOTFOUND
اعطيتكما	عَطاء,أَعْطَى
اعطيات	عَطاء
اعطوها	أَعْطَى
اعطوكم	أَعْطَى
اعطهما	أَعْطَى
اعطنيهن	NOTFOUND
اعطته	أَعْطَى
اعطاهموه	NOTFOUND
اعطانيهن	NOTFOUND
اعطاكم	أَعْطَى
اعطاءه	إِعْطاء
اعضائك	عُضْو
اعصيه	عَصَى-ِ
اعصيك	عَصَى-ِ
اعصمني	عَصَم-ِ
اعصره	عَصَر-ِ,عَصَّر,عَصْر
اعصار	إِعْصار,عَصْر
اعشر	عَشَّر
اعسار	إِعْسار
اعزير	NOTFOUND
اعزله	أَعْزَل,عَزَل-ِ
اعزك	عَزَى-ِ,عَزَّى,عَزا,أَعَزّ,عاز,عَزِي-َ
اعرك	عار-َ,عَرّ,عَرَّى,أَعار,عَرا,عار-ِ,عَرَك,عَرِي-َ
اعرفني	عَرَّف,عَرَف-ِ
اعرفن	NOTFOUND
اعرضتمو	NOTFOUND
اعرضتم	أَعْرَض
اعرتك	أَعار
اعراف	عُرْف
اعراضهم	عَرَض,إِعْراض,عِرْض
اعراضك	عَرَض,إِعْراض,عِرْض
اعراض	عَرَض,إِعْراض,عِرْض
اعرابية	أَعْرابِيّ
اعرابيان	أَعْرابِيّ
اعذني	عَذِي-َ,عاذ,عَذا,أَعاذ
اعذره	أَعْذَر,عَذَر-ِ
اعذر	أَعْذَر,عَذَر-ِ
اعده	عَدّ,عَدَّى,أَعْدَى,أَعاد,عَدا,وَعَد-ِ,عاد,أَعَدّ
اعدلتمونا	NOTFOUND
اعدك	عَدّ,عَدَّى,أَعْدَى,أَعاد,عَدا,وَعَد-ِ,عاد,أَعَدّ
اعدت	أَعْدَى,أَعاد,أَعَدّ
اعداد	عَدَد,إِعْداد
اعداء	عَدُوّ
اعجنيه	NOTFOUND
اعجمي	أَعْجَم,أَعْجَمِيّ
اعجلهم	عَجَّل,أَعْجَل,عَجِل-َ
اعجلها	عَجَّل,أَعْجَل,عَجِل-َ
اعجلنا	عَجَّل,أَعْجَل,عَجِل-َ
اعجلتهم	أَعْجَل
اعجزتم	أَعْجَز
اعجابا	إِعْجاب,عَجَب
اعتنق	ٱِعْتَنَق
اعتموا	ٱِعْتَمّ,أَعْتَم
اعتمري	NOTFOUND
اعتمرنا	ٱِعْتَمَر
اعتمرتم	ٱِعْتَمَر
اعتمرت	ٱِعْتَمَر
اعتلوا	ٱِعْتَلَى,ٱِعْتَلّ
اعتل	ٱِعْتَلَى,عَتَل,ٱِعْتَلّ
اعتقوا	أَعْتَق
اعتقهم	عَتُق,أَعْتَق,ٱِعْتاق
اعتقتهما	أَعْتَق,ٱِعْتاق
اعتقتها	أَعْتَق,ٱِعْتاق
اعتقته	أَعْتَق,ٱِعْتاق
اعتقا	أَعْتَق
اعتزلهن	NOTFOUND
اعتزلت	ٱِعْتَزَل
اعتزال	ٱِعْتِزال
اعترضوا	ٱِعْتَرَض
اعترضها	ٱِعْتَرَض
اعترضني	ٱِعْتَرَض
اعتدال	ٱِعْتِدال
اعتداد	ٱِعْتِداد
اعتجن	NOTFOUND
اعتبروها	ٱِعْتَبَر
اعبر	عَبَر,عَبَّر
اعالجه	عالَج
اعاض	أَعاض
اعارية	إِعارِيّ
اعاروا	أَعار
اعاره	عار-َ,أَعار,إِعارَة
اعادته	أَعاد,إِعادَة
اعادت	أَعاد
اعادة	عادَى,أَعاد,إِعادَة
اعاجيب	أُعْجُوبَة
اعائدا	NOTFOUND
اظهار	ظُهْر,إِظْهار
اظنني	ظَنّ
اظلهما	أَظَلّ,ظَلّ-َ
اظلمك	أَظْلَم,ظَلَم-َِ
اظلمتك	NOTFOUND
اظلافهن	ظِلْف
اظلافهم	ظِلْف
اظفر	ظَفِر-َ,أَظْفَر,ظَفَّر
اطين	طَيَّن
اطيط	أَطِيط
اطيبه	طَيَّب,أَطاب,أَطْيَب
اطولنا	أَطْوَل,طَوَّل
اطولكم	أَطْوَل,طَوَّل
اطهرك	طَهَّر
اطمارها	طِمْر
اطلنا	أَطَلّ,طَلّ,طَلَى-ِ,أَطال
اطلقتهن	أَطْلَق
اطلعتم	أَطْلَع,ٱِطَّلَع
اطلتها	أَطَلّ,أَطال
اطلت	أَطَلّ,أَطال
اطلبوها	NOTFOUND
اطلبها	طَلَب
اطلبني	طَلَب
اطلبك	طَلَب
اطقت	أَطاق
اطفاها	NOTFOUND
اطفالكم	طِفْل
اطفات	NOTFOUND
اطفئت	NOTFOUND
اطعميه	NOTFOUND
اطعموهن	أَطْعَم
اطعموهم	أَطْعَم
اطعموه	أَطْعَم
اطعمونا	أَطْعَم
اطعمهم	أَطْعَم,طَعَّم,طَعِم-َ
اطعمها	أَطْعَم,طَعَّم,طَعِم-َ
اطعمنيها	NOTFOUND
اطعمكم	أَطْعَم,طَعَّم,طَعِم-َ
اطعمتني	أَطْعَم
اطعمتنا	أَطْعَم,طَعام
اطعتيه	NOTFOUND
اطعتموهم	أَطاع
اطعتم	أَطاع
اطري	طَرَّى,إِطار,طَرِي-َ,أَطْرَى
اطرد	طَرَد,ٱِطَّرَد
اطرحوا	ٱِطَّرَح
اطرحه	طَرَّح,طَرَح-َ,ٱِطَّرَح
اطرح	طَرَّح,طَرَح-َ,ٱِطَّرَح
اطرت	أَطَّر,أَطَر-ُِ,أَطْرَى
اطرافي	طَرَف
اطرافها	طَرَف
اطبخوا	NOTFOUND
اطبخ	طَبَخ-َُ
اطباق	طَبَق,إِطْباق
اطامهم	أُطُم,أُطام
اطالوا	أَطال
اطالهما	أَطال
اطالها	أَطال
اطالب	طالَب
اطاقت	أَطاق
اطاق	أَطاق
اطافت	أَطاف
اطاعك	أَطاع
اطاردها	طارَد
اضيق	أَضْيَق,ضَيَّق,ضاق
اضيع	ضاع-ِ,أَضاع,ضَيَّع
اضيبع	NOTFOUND
اضيافا	NOTFOUND
اضوا	آض-ِ
اضوئهم	ضَوَّأ
اضوؤهم	NOTFOUND
اضني	ضَنِي-َ,أَضْنَى,آض-ِ
اضمن	ضَمِن-َ,ضَمَّن
اضمم	ضَمّ
اضلوا	أَضَلّ
اضللن	أَضَلّ
اضللتها	أَضَلّ
اضلتها	أَضَلّ
اضلتا	أَضَلّ
اضلت	أَضَلّ
اضفه	أَضاف,أَضْفَى,ضَفا
اضعفت	أَضْعَف
اضطركم	ٱِضْطَرّ
اضطررنا	ٱِضْطَرّ
اضطربت	ٱِضْطَرَب
اضطر	ٱِضْطَرّ
اضطبع	NOTFOUND
اضرهم	ضَرّ,ضَرَّى,أَضَرّ,ضار,ضار-ِ
اضربته	أَضْرَب
اضراسه	ضِرْس
اضحوا	أَضْحَى
اضحاة	أَضْحَى,أَضْحاة
اضبط	ضَبَط,أَضْبَط
اضافها	أَضاف
اضاعه	إِضاعَة,أَضاع
اضاحيهم	أُضْحِيَّة
اصيهب	NOTFOUND
اصيفر	NOTFOUND
اصيبا	أَصاب
اصوت	صات,صَوَّت
اصواتكما	صَوْت
اصواتا	صَوْت
اصهار	صِهْر
اصمتت	أَصْمَت
اصلهم	أَصْل,أَصَلَة,صال,وَصَل-ِ,صَلِي-َ,صَلَّى,أَصْلَى,صَلَى-ِ
اصلنا	أَصَلَة,أَصْل,صال,صَلِي-َ,وَصَل-ِ,صَلَّى,صَلَى-ِ,أَصْلَى
اصلع	أَصْلَع,صَلِع-َ
اصلحيها	أَصْلَح
اصلحوها	أَصْلَح
اصلحه	صَلَّح,أَصْلَح
اصلاحا	إِصْلاح
اصلاتان	NOTFOUND
اصلاة	أَصْل,أَصْلَى
اصفه	صَفا,صَفَّى,أَصْفَى,صَفّ,وَصَف-ِ
اصغي	صَغِي-َ,أَصْغَى,صَغا
اصعر	صَعِر-َ,صَعَّر
اصطوانة	NOTFOUND
اصطنعوا	ٱِصْطَنَع
اصطنعته	ٱِصْطَنَع
اصطلحوا	ٱِصْطَلَح
اصطلحنا	ٱِصْطَلَح
اصطفينا	ٱِصْطَفَى
اصطفوا	ٱِصْطَفّ,ٱِصْطَفَى
اصطففنا	ٱِصْطَفّ
اصطرف	NOTFOUND
اصطدت	ٱِصْطاد
اصطبر	ٱِصْطَبَر
اصطاده	ٱِصْطاد
اصرعه	صَرَع-َ
اصدنا	أَصَدّ,صَدّ,أَصَّد,صَدِي-َ,أَصْدَى,صاد-ِ,صَدَّى
اصدقكم	أَصْدَق,صَدَّق
اصدقة	أَصْدَق,صَدَّق
اصدقاء	صَدِيق
اصدعها	صَدَّع,صَدَع-َ
اصدرتنا	أَصْدَر
اصداء	صَدَى,إِصْداء
اصحبه	صَحِب-َ,أَصْحَب
اصحابهما	صاحِب
اصبوت	NOTFOUND
اصبهان	NOTFOUND
اصبه	صَبّ,وَصَب-ِ,أَصاب,صَبا,صَبِي-َ,صَبّ-َ,صَبَّى
اصبعك	صَبَع-َ,إِصْبَع
اصبرني	صَبَّر
اصبحي	NOTFOUND
اصبحا	أَصْبَح
اصبتها	أَصاب
اصبتني	أَصاب
اصبتموه	أَصاب
اصالحك	صالَح
اصاغرنا	NOTFOUND
اصادفته	NOTFOUND
اصابوها	أَصاب
اصابهما	أَصاب
اصابعهما	إِصْبَع
اصابعهم	إِصْبَع
اصابعها	إِصْبَع
اصابعنا	إِصْبَع
اصابعك	إِصْبَع
اصابتكم	إِصابَة,أَصاب
اشيع	أَشاع,شَيَّع,شاع-ِ
اشيخة	شاخ-ِ
اشياخه	شَيْخ
اشوي	شَوَى-ِ
اشواطا	شَوْط
اشهيد	NOTFOUND
اشهدي	NOTFOUND
اشهدهم	شَهِد-َ,أَشْهَد
اشهده	شَهِد-َ,أَشْهَد
اشمكم	وَشَم-ِ,شَمّ,أَشَمّ
اشمط	ٱِشْمَطّ,شَمِط-َ,أَشْمَط
اشمته	أَشْمَت,شَمَّت,شَمِت-َ
اشكر	شَكَر
اشكاله	إِشْكال,شَكْل
اشقيت	أَشْقَى
اشقاهم	أَشْقَى
اشفيكم	أَشْفَى,شَفَى
اشفقنا	شَفِق-َ,أَشْفَق
اشغلني	شَغَّل,شَغَل-َ,أَشْغَل
اشغل	شَغَّل,شَغَل-َ,أَشْغَل
اشغال	إِشْغال,شُغْل
اشعبها	أَشْعَب,شَعَّب
اشعارهن	شِعْر,شَعْر,إِشْعار
اشرها	شَرَى-ِ,أَشَّر,أَشار,أَشِر,وَشَر-ِ,أَشَر,أَشَر-ِ
اشركوا	أَشْرَك
اشرفتم	أَشْرَف
اشربها	أَشْرَب,شَرِب-َ,شَرَّب
اشربتها	أَشْرَب
اشربتم	أَشْرَب
اشربت	أَشْرَب
اشراكا	إِشْراك,شَرَك
اشراك	إِشْراك,أَشَّر,أَشِر,شَرَك,أَشَر,أَشَر-ِ
اشدهن	شَدّ-ُِ,شَدا,أَشَدّ,شاد-ِ,أَشاد,أَشُدّ
اشدها	شَدّ-ُِ,شَدا,أَشَدّ,أَشاد,شاد-ِ,أَشُدّ
اشخص	أَشْخَص,شَخَّص
اشجعيا	NOTFOUND
اشجابه	NOTFOUND
اشجاب	NOTFOUND
اشتووها	NOTFOUND
اشتهيتها	ٱِشْتَهَى
اشتهيت	ٱِشْتَهَى
اشتكها	ٱِشْتَكَى
اشتكاه	ٱِشْتَكَى
اشتريا	ٱِشْتَرَى
اشترها	ٱِشْتَرَى,شَتَر-ِ
اشتره	ٱِشْتَرَى,شَتَر-ِ
اشتركا	ٱِشْتَرَك
اشترك	ٱِشْتَرَى,شَتَر-ِ,ٱِشْتَرَك
اشتراطك	ٱِشْتِراط
اشتدت	ٱِشْتَدّ
اشتاتا	شَتّ
اشبيب	NOTFOUND
اشبهنا	شَبَّه,أَشْبَه
اشبهكم	شَبَّه,أَشْبَه
اشبعناه	أَشْبَع
اشبعك	شَبِع-َ,أَشْبَع,شَبَّع
اشباهها	شَبَه,شِبْه
اشباهه	شَبَه,شِبْه
اشافهها	شافَه
اشافه	شافَه
اشاد	شادّ,أَشاد
اسيرها	سَيَّر,سار-ِ,أَسار,أَسِير
اسية	أُسّ,أُسِّيَّة,آسِي,آس,أُسِّيّ
اسيبه	ساب-ِ,سَيَّب
اسوي	سَوَّى,سَوِي-َ
اسوقهما	سَوَّق,ساق
اسوقها	سَوَّق,ساق
اسوسه	ساس
اسودوا	ٱِسْوَدّ
اسودان	أَسْوَد
اسواقهم	سُوق
اسواقها	سُوق
اسواقنا	سُوق
اسواق	سُوق
اسوارين	إِسْوار
اسهمي	أَسْهُمِيّ,سَهْم
اسهما	أُسّ,آس,أَسْهَم,سَهْم
اسهرت	أَسْهَر
اسنن	أَسَنّ,سَنَّن,سَنّ
اسنمتها	سَنام
اسندوا	أَسْنَد
اسنت	أَسِن-َ,أَسَنّ
اسنانه	سِنّ
اسنادهم	إِسْناد,سَنَد
اسميهما	ٱِسْمِيّ,سَمَّى,ٱِسْم,أَسْمَى
اسميهم	ٱِسْمِيّ,سَمَّى,ٱِسْم,أَسْمَى
اسمنها	سَمَّن,أَسام,أَسْمَن,سَمِن-َ
اسممت	NOTFOUND
اسمعتهم	أَسْمَع
اسمعتنا	أَسْمَع
اسمختهم	NOTFOUND
اسمان	ٱِسْم
اسمال	سَمَل
اسمائكم	ٱِسْم
اسماءهم	ٱِسْم
اسماءكم	ٱِسْم
اسلمتما	أَسْلَم
اسلكوا	أَسْلَك
اسلكها	سَلَّك,أَسْلَك,سَلَك
اسلفوا	أَسْلَف
اسلخها	سَلَخ-َُ
اسلامهما	إِسْلام
اسلال	NOTFOUND
اسلافهم	سَلَف
اسلابهم	أَسْلاب
اسكنه	أَسْكَن,سَكَّن
اسكندراني	NOTFOUND
اسكنت	أَسْكَن
اسكركن	أَسْكَر,سَكِر-َ,سَكَّر
اسكتتها	أَسْكَت
اسكاتك	إِسْكات
اسكاتة	إِسْكات
اسقيها	سَقَى-ِ,أَسْقَى
اسقيتنا	أَسْقَى,سِقاء
اسقوا	أَسْقَى
اسقم	سَقُم,سَقِم-َ,سَقَّم,أَسْقَم
اسقطه	أَسْقَط,سَقَط
اسقاني	أَسْقَى
اسقانا	أَسْقَى
اسفلهم	أَسْفَل
اسفرتم	أَسْفَر
اسفرت	أَسْفَر
اسفاركم	سَفَر,سِفْر
اسفارا	سَفَر,سِفْر
اسعدهم	أَسْعَد
اسعدننا	أَسْعَد
اسعارها	سِعْر
اسعاد	إِسْعاد
اسطوانتين	أُسْطُوانَة
اسطوانة	أُسْطُوانَة
اسطوانا	أُسْطَى
اسرها	أُسْرَة,أَسَر-ِ,سَرَّى,سار-ِ,سَرَى-ِ,أَسَرّ,أَسار,سَرّ,أُسْر,أَسْرَى,أَسْر
اسرق	سَرَق-ِ,سَرَّق
اسرعهن	سَرَّع,سَرُع,أَسْرَع
اسرعنا	سَرَّع,سَرُع,أَسْرَع
اسرعكن	سَرَّع,سَرُع,أَسْرَع
اسرجوا	أَسْرَج
اسرة	أُسْرَة,سُرّ,أَسَر-ِ,سَرَّى,سار-ِ,سَرَى-ِ,أَسَرّ,أَسار,سَرّ,أُسْر,أَسْرَى,أَسْر
اسراهم	أَسَر-ِ,أَسَرّ,أَسِير,أَسْرَى
اسراكم	أَسَر-ِ,أَسِير,أَسَرّ,أَسْرَى
اسرافيل	إِسْرافِيل
اسراعك	إِسْراع,سُرْع
اسراءكم	أَسِير,إِسْراء
اسدلنا	سَدَل,سَدَّل,أَسْدَل
اسدل	سَدَل,سَدَّل,أَسْدَل
اسخطتم	أَسْخَط
اسحاقبن	NOTFOUND
اسجدها	سَجَد
استيقانا	NOTFOUND
استيقاظهما	ٱِسْتِيقاظ
استياسوا	NOTFOUND
استياست	NOTFOUND
استوينا	ٱِسْتَوَى
استوكف	NOTFOUND
استوقف	ٱِسْتَوْقَف
استوقدوا	ٱِسْتَوْقَد
استوفيت	ٱِسْتَوْفَى
استوعي	NOTFOUND
استوعبت	ٱِسْتَوْعَب
استودعكها	NOTFOUND
استودعك	ٱِسْتَوْدَع
استودعتني	ٱِسْتَوْدَع
استوخمنا	NOTFOUND
استوجبته	ٱِسْتَوْجَب
استهزاء	ٱِسْتِهْزاء
استها	آسَى,ٱِسْت,أَسا,أَسَّى
استنكه	NOTFOUND
استنكرنا	ٱِسْتَنْكَر
استنقذتها	ٱِسْتَنْقَذ
استنقذته	ٱِسْتَنْقَذ
استنفرت	ٱِسْتَنْفَر
استنفر	ٱِسْتَنْفَر
استنظره	ٱِسْتَنْظَر
استنصحك	ٱِسْتَنْصَح
استنشدني	ٱِسْتَنْشَد
استنزلوهم	ٱِسْتَنْزَل
استنبطت	ٱِسْتَنْبَط
استنانا	ٱِسْتَنّ
استمدوا	ٱِسْتَمَدّ
استمتعناها	ٱِسْتَمْتَع
استلمك	ٱِسْتَلَم
استلمتك	ٱِسْتَلَم
استلقي	ٱِسْتَلْقَى
استلامهما	ٱِسْتِلام
استلالا	NOTFOUND
استكملت	ٱِسْتَكْمَل
استكفي	ٱِسْتَكْفَى
استكسيت	NOTFOUND
استكراء	NOTFOUND
استكثروا	ٱِسْتَكْثَر
استكثر	ٱِسْتَكْثَر
استقينا	ٱِسْتَقَى
استقي	ٱِسْتَقَى
استقمنا	ٱِسْتَقام
استقمت	ٱِسْتَقام
استقل	ٱِسْتَقال,ٱِسْتَقَلّ
استقطع	ٱِسْتَقْطَع
استقضاه	ٱِسْتَقْضَى
استقصروه	ٱِسْتَقْصَر
استقصروا	ٱِسْتَقْصَر
استقصره	ٱِسْتَقْصَر
استقصاء	ٱِسْتِقْصاء
استقرت	ٱِسْتَقَرّ,ٱِسْتَقْرَى
استقراتك	NOTFOUND
استقرئ	ٱِسْتَقْرَأ
استقبلوا	ٱِسْتَقْبَل
استقبلهم	ٱِسْتَقْبَل
استقبلني	ٱِسْتَقْبَل
استقامت	ٱِسْتَقام
استقال	ٱِسْتَقال
استفضله	NOTFOUND
استفضل	NOTFOUND
استفرجت	NOTFOUND
استفدت	ٱِسْتَفاد
استفاضة	ٱِسْتِفاضَة,ٱِسْتَفاض
استفاء	NOTFOUND
استغنيت	ٱِسْتَغْنَى
استغفروه	ٱِسْتَغْفَر
استغفرتني	ٱِسْتَغْفَر
استغفارا	ٱِسْتِغْفار
استغاثوا	ٱِسْتَغاث
استعيذي	NOTFOUND
استعنت	ٱِسْتَعان
استعملنا	ٱِسْتَعْمَل
استعمركم	ٱِسْتَعْمَر
استعمال	ٱِسْتِعْمال
استعفوا	ٱِسْتَعْفَى
استعف	ٱِسْتَعْفَى
استعظاما	NOTFOUND
استعط	ٱِسْتَعْطَى,ٱِسْتَعَط
استعصت	ٱِسْتَعْصَى
استعز	ٱِسْتَعَزّ
استعدي	ٱِسْتَعْدَى
استعدادا	ٱِسْتِعْداد
استعجلوا	ٱِسْتَعْجَل
استعجلتم	ٱِسْتَعْجَل
استعجل	ٱِسْتَعْجَل
استعاذني	ٱِسْتَعاذ
استعاذكم	ٱِسْتَعاذ
استطيعه	NOTFOUND
استطعمك	ٱِسْتَطْعَم
استطعمتك	ٱِسْتَطْعَم
استطالة	ٱِسْتِطالَة
استطاعوا	ٱِسْتَطاع
استطاب	ٱِسْتَطاب
استصفيته	ٱِسْتَصْفَى
استشيرك	ٱِسْتَشار
استشير	ٱِسْتَشار
استشرفها	ٱِسْتَشْرَف
استشرفت	ٱِسْتَشْرَف
استسلفك	NOTFOUND
استسقيتك	ٱِسْتَسْقَى
استسقيت	ٱِسْتَسْقَى
استسقاك	ٱِسْتَسْقَى
استسقاء	ٱِسْتِسْقاء
استسراعك	NOTFOUND
استزدنه	ٱِسْتَزاد
استزدناه	ٱِسْتَزاد
استرهبوهم	NOTFOUND
استرقيت	NOTFOUND
استرقوا	ٱِسْتَرَقّ,ٱِسْتَرَق
استرقني	ٱِسْتَرَق
استرق	ٱِسْتَرَقّ,ٱِسْتَرَق
استرعي	ٱِسْتَرْعَى
استرضع	NOTFOUND
استرخاءفقال	NOTFOUND
استرحنا	ٱِسْتَراح
استرحمت	ٱِسْتَرْحَم
استرجاعا	ٱِسْتِرْجاع
استراح	ٱِسْتَراح
استدرت	ٱِسْتَدَرّ,ٱِسْتَدار
استدانت	ٱِسْتَدان
استخلصني	ٱِسْتَخْلَص
استخرجوك	ٱِسْتَخْرَج
استخرجهم	ٱِسْتَخْرَج
استخرجته	ٱِسْتَخْرَج
استخرجت	ٱِسْتَخْرَج
استخرج	ٱِسْتَخْرَج
استخبره	ٱِسْتَخْبَر
استخبركم	ٱِسْتَخْبَر
استخبتا	NOTFOUND
استخارة	ٱِسْتَخار
استحييك	ٱِسْتَحْيَى
استحيوا	ٱِسْتَحْيَى
استحيت	ٱِسْتَحْيَى
استحملناك	NOTFOUND
استحمدوا	NOTFOUND
استحلوه	ٱِسْتَحَلّ
استحللناه	ٱِسْتَحَلّ
استحقوا	ٱِسْتَحَقّ
استحقت	ٱِسْتَحَقّ
استحق	ٱِسْتَحَقّ
استحضت	NOTFOUND
استحد	NOTFOUND
استحثثت	ٱِسْتَحَثّ
استحباها	ٱِسْتَحَبّ
استجنح	NOTFOUND
استجاروا	ٱِسْتَجار
استثنيت	ٱِسْتَثْنَى
استثناء	ٱِسْتِثْناء
استثقل	ٱِسْتَثْقَل
استثفري	NOTFOUND
استثفرت	NOTFOUND
استتيب	ٱِسْتَتاب
استتم	ٱِسْتَتَمّ
استتبهم	ٱِسْتَتَبّ,ٱِسْتَتاب
استتابه	ٱِسْتَتاب
استبقي	ٱِسْتَبْقَى
استبشروا	ٱِسْتَبْشَر
استبشر	ٱِسْتَبْشَر
استبراء	ٱِسْتِبْراء
استبدلوا	ٱِسْتَبْدَل
استبا	ٱِسْتَبّ
استاه	آسَى,ٱِسْت,أَسا,سَتْه,أَسَّى
استامن	NOTFOUND
استامروا	NOTFOUND
استامرت	NOTFOUND
استاقوا	ٱِسْتاق
استاصلت	NOTFOUND
استاذنوكم	NOTFOUND
استاذنهن	NOTFOUND
استاذنتها	NOTFOUND
استاخروا	NOTFOUND
استاخرن	NOTFOUND
استاخرت	NOTFOUND
استاثرها	NOTFOUND
استئنافا	ٱِسْتِئْناف
استئصال	ٱِسْتِئْصال
استؤصل	NOTFOUND
اسبوعا	أُسْبُوع
اسبل	أَسْبَل,سَبَّل
اسبقه	سَبَّق,أَسْبَق,سَبَق-ُِ
اسبع	سَبْع,سَبَّع
اسانيدها	إِسْناد
اسافلها	أَسْفَل
اسافل	أَسْفَل
اسافا	NOTFOUND
اسابقك	سابَق
اساببت	NOTFOUND
اساءتهم	أَساء,إِساءَة
اساءتك	أَساء,إِساءَة
اسا	أُسّ,آس,أَسا
اس	أُسّ,آسِي,آس,إِس
ازيده	أَزْيَد,زاد-ِ,زَيَّد,أَزاد
ازيدن	NOTFOUND
ازودتهم	أَزْواد
ازوجه	زَوَّج
ازواجهما	زَوْج
ازو	زَوَى-ِ,زَوَّى
ازهد	زَهَّد,زَهُد,زَهَد-َ
ازنيت	NOTFOUND
ازمان	زَمَن,آزِم
ازكيه	زَكَّى,أَزْكَى
ازق	زَقّ,زَقا,أَزَق-ِ
ازرهن	أَزار,زَرَى-ِ,وَزَر-ِ,أَزْر,آزَر,أَزَّر,أَزَر-ِ,زَرّ,زار,إِزار,أَزْرَى
ازرقان	أَزْرَق
ازرتني	أَزار,آزَر,أَزَّر,أَزَر-ِ,أَزْرَى
ازدية	NOTFOUND
ازدحمنا	ٱِزْدَحَم
ازدادوا	ٱِزْداد
ازحف	زَحَف-َ
ازجروا	NOTFOUND
ازاغ	أَزاغ
ازاد	زاد-ِ,أَزاد
اريهم	وَرَى-ِ,أَري,آرِيّ
اريه	وَرَى-ِ,أَري,آرِيّ
ارينيه	NOTFOUND
اريني	وَرَى-ِ
ارينك	ران-ِ
اريكه	أَرِيكَة
اريكة	أَرِيكَة
اريصح	NOTFOUND
اريتكن	آرِيّ
اروها	أَرْوَى,رَوَى-ِ,رَوَّى
ارواه	أَرْوَى
ارواحهما	رُوح,رِيح
ارهقهما	أَرْهَق,رَهِق-َ
ارهقتنا	أَرْهَق
ارهبهم	رَهَّب,أَرْهَب
ارميه	رَمَى-ِ,إِرَم
ارمني	رام-ِ,رَمَى-ِ,أَرْمَنِيّ,رَمّ,أَرَم-ِ,أَرَّم,رام
ارمك	رام-ِ,أَرْمَك,رَمَى-ِ,أُرَّم,إِرَم,رَمّ,أَرَم-ِ,أَرَّم,رام
ارماها	إِرَم,أَرَم-ِ,أَرَّم
اركعوا	أَرْكَع
اركسهم	NOTFOUND
اركبوا	أَرْكَب
اركبه	رَكَّب,رَكِب-َ,أَرْكَب
اركبا	أَرْكَب
ارقبوه	NOTFOUND
ارفقوا	أَرْفَق
ارفعوني	NOTFOUND
ارفعونا	NOTFOUND
ارفعهن	رَفَع-َ,أَرْفَع,رَفَّع
ارفعها	رَفَع-َ,أَرْفَع,رَفَّع
ارفعكم	رَفَع-َ,أَرْفَع,رَفَّع
ارفض	ٱِرْفَضّ,رَفَض,أَرْفَض
ارفانا	أَرَّف
ارفئوا	NOTFOUND
ارغبت	NOTFOUND
ارعاه	أَرْعَى,رَعَى-َ
ارعاء	NOTFOUND
ارطب	رَطُب,رَطَّب,رَطِب-َ,أَرْطَب
ارضيهما	أَرْضِيّ,أَرْضَى,رَضَّى,أَرْض
ارضيهم	أَرْضِيّ,أَرْضَى,رَضَّى,أَرْض
ارضيه	أَرْضِيَّة,أَرْضِيّ,أَرْضَى,رَضَّى,أَرْض
ارضينا	أَرْضِيّ,أَرْضَى,رَضَّى,أَرْض
ارضيت	أَرْضَى
ارضوهم	أَرْضَى,أَرَّض,أَرْض
ارضون	أَرْض
ارضعتهما	أَرْضَع
ارضعتنا	أَرْضَع
ارشك	راش,أَرْش,رَشّ,رَشا,وَرَش-ِ
ارشدهما	رَشَّد,أَرْشَد
ارشدني	رَشَّد,أَرْشَد
ارسلوهما	أَرْسَل
ارسلها	أَرْسَل
ارسلتيها	NOTFOUND
ارسلته	أَرْسَل
ارسلاه	أَرْسَل
ارسلا	أَرْسَل
ارساله	إِرْسال
ارزقه	رَزَق
ارزاقنا	رِزْق
ارديهم	رَدَّى,أَرَدّ,أَرْدَى,أُرْدِيّ
اردهن	رَدِي-َ,راد,أَرَدّ,رَدَّى,أَرْدَى,أَراد,رَدّ,وَرَد-ِ
اردهما	رَدِي-َ,راد,أَرَدّ,رَدَّى,أَراد,أَرْدَى,رَدّ,وَرَد-ِ
اردفها	أَرْدَف,رَدِف-َ,رَدَف
ارددها	رَدَّد,رَدّ
اردده	رَدَّد,رَدّ
اردته	أَرْدَى,أَراد
اردتم	أَراد
ارخصها	أَرْخَص,رَخَّص
ارحنا	راح,أَراح
ارحلوا	NOTFOUND
ارحل	رَحَّل,رَحَل-َ
ارحاما	رَحِم
ارحام	رَحِم
ارح	راح,أَراح
ارجوان	أُرْجُوان
ارجموهما	NOTFOUND
ارجموا	NOTFOUND
ارجعوها	أَرْجَع
ارجعن	أَرْجَع
ارجعته	أَرْجَع
ارجز	NOTFOUND
ارتوي	ٱِرْتَوَى
ارته	أَرَتّ,رَتَّى,رَتا
ارتمي	ٱِرْتَمَى
ارتقبنا	ٱِرْتَقَب
ارتفعنا	ٱِرْتَفَع
ارتضي	ٱِرْتَضَى
ارتضاعه	NOTFOUND
ارتخصتم	NOTFOUND
ارتحلني	ٱِرْتَحَل
ارتجعها	NOTFOUND
ارتجز	ٱِرْتَجَز
ارتبطوا	ٱِرْتَبَط
ارتبط	ٱِرْتَبَط
اربيتما	أَرْبَى
اربونا	أَرَب-ِ,آرَب,أَرِب,أَرْبَى,رَبا
